Logger	KEYWORD1
getLogger	KEYWORD2
on	KEYWORD2
off	KEYWORD2
setLevel	KEYWORD2
timeRaw	KEYWORD2
functionTime	KEYWORD2
count	KEYWORD2
variableCount	KEYWORD2
version	KEYWORD2
print	KEYWORD2
rawData	KEYWORD2
rawVar	KEYWORD2
IGNORE_SS	LITERAL1
ERROR	LITERAL1
WARNING	LITERAL1
DEBUG	LITERAL1
INFO	LITERAL1
T_TIME	LITERAL1
T_COUNT	LITERAL1
T_VERSION	LITERAL1
T_PRINT	LITERAL1
